
https://netfree2.cc/mobile/home
Nostalgic  doesn’t happen overnight  I insisted.=== maine jorr diya  puffy==phooli lagi   dab=दबाना=clamp,press   instill==dalta hai==paida karta hai  scrunch==kuchalna==screak==grind

puking ==ultiya aana slam==patak dena   snickered===hassi uriyee  weird==bizarre   from a nap== jhapki se  creepy===सनसनी डालनेवाला  pleaded==request   grin===muskrahat
sluped ==align 
crub ==piece     squint==तिरछी दूष्टि से देखना     feasible==संभव==practical
gazed down at=== ghoorkar dekhna   stigama==kalank   to gain benefits==to gain benefits,   misuse===दुरुपयोग करना  को रोकने==curbing==control,take control,check out  put ==dalna=rakhna
 rolled out===lurkna 
gasp === dum tor dena
howl ==cheekh  ,, synergy==तालमेल  disclosure==खुलासा  fosters==प्रोत्साहन देना intense===gahan  novelty==नवीनता
shrill = teekhi
growingl ==gurrana   messed=गड़बड़==mess  my heart pounding.==मेरा दिल जोरों से धड़कने लगा   snappy==speed==teaz  pounce==झपटे   stalking==peecha karna
  stammer=flater==haklna  limp==langar  wail==chillana =yell  flapped==फड़फड़ाते  shuffle ==फेर-बदल   sigh==आह  startled===चौंका दिया sprung==uchala==leap

initiative(pahal)=enterprises [substainable=longlsatic]
sanction=ban  [alleged=कथित=so called]   [ailment=insurance] ease=comfort [fade=to lose freshness] [harass=to truble] [hardship=ill luck] [identical=similar]
hale=healthy [impart=to provide] [impair=damage] [impel=to force someone][implicate=to bring charge against]
(exclude=निकालना,withdraw,draw,out,scoop,emit,seprate)
intended=अभिप्रेत [whatif=अगर] [initiated=started],[endeavour=practice]
[perspective=परिप्रेक्ष्य =project,plan,possibility   [bland =naram] [rancid=badpudar] [ winsome = manmohar]
regardless=बेपरवाह neglectful
[superstition = andhvishwash] [stir=aphara tafari==mess] [compulsion = vivashta] 
sieze = ghera dalana [ even after =ke baad bhi] [some of them =unme se kuch][spat=umbon]  [verbose=sabdhbahul]  विलाप किया==wail  messy===ast-vayst
allure=lubhana   [embedded =अंतर्निहित]  [prompt=immediately=तत्पर] naive=अनाड़ी=forever=straight forward
{literaly= sachmuch= truth} 
testimony=gavahi [compulsion=majbori] [enforce=lagu karna][ailment=ill] inclusive=[समावेशी,containing,including],workaround=solution 
extract=[निकालना]=sumarries,essence,substance, extract  galvanise=motivated ,hurdle=hindrance(badha) vanguard=facecard=मोहरा

mitigationशमन
yardstickमापदंड  squat==sit beside   sickening ==घिनौना==odius=slimy  pounding==gherna==teaj   खींचकर खोल दिया==pulled  open    फटा आवाज़==screech   organized==AAYOZAN


acquire ==arzit karta lay foundation=== नींव रखता  priceless treasures of==अनमोल धरोहरें    make us ko use karte hai ke term me hota hai    APART FROM THIS ==ISKE ALWA

आत्म-सम्मान (dignity)  entitled===adhakar
however==par   ,,, yet ==phir bhi  since ,as==chooki  though===halniki==ALTHOUGH   eventhought ==bhale hi                

 "Could we talk about something else?"
There was no limit to my happiness!     मेरी खुशी का ठिकाना नहीं रहा!
What do you have for lunch

